


      
F 220  ,   100 ,0

                 NO                    ./textures/redbrick.xpm
                        SO  ./textures/wood.xpm
WE                                ./textures/bluestone.xpm
C 225            ,30            ,0      
EA ./textures/mossy.xpm

        1
        1
        1
        1
11111111W111111
        1
        1

                      