NO ./textures/64x64/barrel.xpm
SO ./textures/64x64/mossy.xpm
WE ./textures/64x64/qwe.xpm
EA ./textures/64x64/wood.xpm
F 255,255,255
C 255,255,255
11111111111111111111111111111111111111111111111111111111111111
10000000000000000000000000000000000000000000000000000000000001
11111111111111111111111111111111111111111111111111111111111101
                                                           101
 1111111111111111111111111111111111111111111111111111111   101
 1000000000000000000000000000000000000000000000000000001   101
 1011111111111111111111111111111111111111111111111111101   101
 101                                                 101   101
 101    1111111111111111111111111111111111111111     101   101
 101    1000000000000000000000000000000000000001     101   101
 101    1011111111111111111111111111111111111101     101   101
 101    101 1000000001000110001000010001 1000101     101   101
 101    101 1000011101010110101011010101 1010101     101   101
 101    101 100001 10101011010101101010111010101     101   101
 101    101 100001 10001000W10001100010000010001     101   101
 101    101 111111 11111111111111111111111111111     101   101
 101    101                                          101   101
 101    101111111111111111111111111111111111111111111101   101
 101    100000000000000000000000000000000000000000000001   101
 101    111111111111111111111111111111111111111111111111   101
 101                 101                                    101
 1011111111111111111111111111111111111111111111111111111111101
 1000000000000000000000000000000000000000000000000000000000001
 1111111111111111111111111111111111111111111111111111111111111