NO ./textures/64x64/barrel.xpm
SO ./textures/64x64/mossy.xpm
WE ./textures/64x64/pillar.xpm
EA ./textures/64x64/wood.xpm
F 220,111,0
C 225,30,0

11111111111111111111111
10000000000000000000001
10000000011000000000001
10000000011000000000001
10000000000000000000001
1000000000E000000000001
11111111111111111111111